##.##.#..###....##..##.#.##...#..#..##.####..##...###.....##.####.##.##.##...####.######..#.###.#.##..###.#..#####...#.##.#..#.#.#..######..###.##.#..##.#..##..##..#...###.##..####.#..#....#####.#.###..##.....#...#.##.#####.###.###....#.#..###.##.##.#..##.##.#.##..##.##.##..###.#.#....#.##..###.###.#.##......#.##..#..#.#...##.##.....###...#..#...###..##.####..#..##..#.#..###......#.#####....#####..###..####...###.#.####..#.##..#.#####..##...##.#.#.#...##.#...#.##.##..#.#.##....##.####.#.#..#.##.#.#..#..#.#.

.#..###.....###.#..#.#.###.#..##.#.#..#.###.#..##..#.#.#.##.##..###....#..#.#....####.##...##....###
.#.#.##.#..###...#.#.####..#...##.#.#...#..#...#.###...##..#.#..#.#.##..#.##..#.###.##..##..#...#.##
##..##.#....#...#....##.#..####..#.#.####....#.##..##.###...#..#..######.####....#..#.#.#.###..#.###
.##.#.#..#......##......##.#.#.#.###...###.#.##...##..#..#..######.#.##.###.#...#.#.####.#.#.####...
...#..#####..#....###...#.......#.#..####..#....##..#..####...#...#..#.....#..#...#.#.....##..####.#
##..##.....###.#.##.#.###.###.#.#####..#.....#...##.#.##.#...##..#####...##.###..###...#...#.##...##
#.#####..###...#.####.#.#.....##...###.#..##.##...#...##.#..#.###..###.#.##..#.##..##.###.#.#.#...#.
##...#.#...#..####.#.#..###...#####.#######.##..###..#.#.###.#.#.#..#####.##.#......##.#.#.#..##..#.
.#.#.#.#..#...##.#.#..###.###.#.#...##..#..##.####.#########.......#.#.#.#.#.#.#..##.#..#..#....##.#
#######.#.##.##..#......#..#...##..##...#..###.#...#....#.####.##.#.##.....###...##.##..#..##...####
#.###.#....##.##....#.....####.#.####...###..#..###..#..###.##..###.##.##....#####.##...###.#.##..#.
...##...##.###.#.#..........##..##.###..#..#....#..#...#.##.#..####.#.#.###..###..#........###.#.##.
#....#..######....##.######.#.########....#.###.###.#####.#.####.#.....#..#.###.##...........##.###.
..##.#######.##.#..#.#.#.###..........#.#.#...##...###..####.#.#....#.####.#..#.#####..####.##.#.###
...###..#...#.###.#.#######..#####.....#.##.##..##....##....#####.#..#.##..##...##...#.#.##...#.##..
.#...###.#.....#.##.######.#.#..#.....####....#..###.##.........#.###.....#....#.###.....##.#.#.####
.###.##..###....##...##......###...#....#.##....#...#.#.####.#.......#..#.#.######...###........#..#
.###..#...#..#..##....##..#.#.#....#..#.#.....#.##.....#.#####..##...#.###..#...#.##..###.####.#.###
#..#......#####.###.#.##.###...#.#..#....#.##..#..#....#.#..#.##.###...####...##.######.#...#.#..#.#
.#..#...#####..#.#.#.###.#..##..#.##.#...#..#.##.#..#.##..#..#..####.....#......#.#.#.##...#.##..###
..#....#..#..##.####.###.#..####...###.#.####.###.#.##....##.....#.##.#.##....##...#....#.##.#####..
######..#..#...##.#........##.##.#...####...##.....#.##.#.#.#..#.#..##.#...##...#.#.....#.#..#..####
##...#....#.#.#.....#.#.##.#..#...###..######...###..#.#.#....###.####.#######.##.#.#....#..###..#..
##.....#....#.#.##.##.#....#.###...##.##.#....##.#####..###.##.#...#..##..#.###.#.#.#...#.########..
.......###.#.##.....#.##..##..#.#..#.####.#.#...#.##.###.#.##...#..####......#.##.###.#.#...#.....#.
.##.#.##...#..##.#.#...###..#.#...###.##..#........##.#.##...##.########.......##.#.##.####..####.##
#.#..###.#...##.....#....#...##..##.#...##.....#..#####...###.##....#####.####.##.#...#...####....#.
###.####.##....##.#.##.##.....#.##..##.##.##.#.#.##.#..#.###.##..#.##.....#.#...##.##..#.#.##.##.###
#......##..##.##.#.#####.##..###.....#.##.........##..###.##..#...#..###.#..#.####...#####..#..###.#
#.##.#.#...##..#..#.#..#.###.#...#..#...#####....###....#..#.###...#.###.#.#####.#..#....##.##..##.#
..###..###.#..........#.....#...##..##.####.#.##.##.#.#.#..##.#..###..#..#..#...##..#.#..#.#####.#..
.###..#.###..###..#...#...##.#......####...####..#..###.#.######...#.###..##.......##.##.########.##
...#...#...#..##....###.#.###..##.#.#...##....#.#...#.#.#....#..####.####.####..#.#######.#.#.....#.
.#...#....##....#.##...##...##.#..####.....####..##.###..#..##.........##..#...####..##......##.#.#.
##.####.#...####.#..###..#####.#.#######.#.#...###..###....##..##..##..#......#.#..#.###.###.##.#..#
...###.##.####.##....##.....#.#...##.#..#.#.#.##..#.#.###..#..#..##.#.##.#..####..####.....#.#.#..##
#.#.##.##....#.###.##..####.##..#.#..##..#.###.#..###.#....##..#...#...#..#.#.#.#.#....##...##..#.##
####.####.#####.####.##..#.###.#..#..#.....###......#......#...#.#.#....#....#.##.###..#.#.##.#####.
.##.#..#.###.#.#.###.....###.######..#..##.###.#.##..#..#.####..#.##.##.#.###..####..#..##.#########
###..######......#...#..###.##.#...######....#.###....#...###....##.#..##..##.#.##.#....###.###..##.
#....###..##....###...#.#...##..##...#.......#.####.....######..###....###..##...##.#..###.#.##....#
.##.##...##..#..##...########.##..##.##.#......##.##..#####.#.#..######.#####....#.#.....##..####...
#.......##.##.#..#....#.#.###...#.##.##...#..#.#..#..#.#.##.#...##.###.###...#.######......##..###.#
##.###.######.#..###..##.#.#.#.........##...##.####.#.####............###....#...#..#.#####.#..###.#
#####...#..##.#.#.#.#.#..####.##.#####.###.###...###.###.#.##..##...##..##..#.#.#...##...#.####..##.
...##..#...#..#.###..#...#.##...##.##..#.##.#..##.#..#.###....##.#######.###.#.###..#.###..######.##
.#..####....##.#..#.#.######.#..#...##..#....##.#....##.##.###..#...##.....##.###..#.##.....##..#..#
....###.####.#..####.....#....#.###...#.....#..##..#.#####.###.####.#.....#####.......###.###.##..#.
..#...#..#.##..##.###.##......#..#.##..######..####..#.#####..###.######..####...####..#.#####..#...
####....##...#.##.##.####..#..#.#...#..###.##..###...#......#.#..##..#.##....######.........##..##.#
..#...#.####.###.#.#..###..#.####..#.#.#.#..#..#..###.#...#...#.##.#.#####.##..#.##.##.......#..##..
##...#.##...##.#..###########.#.#.#####.#.##.#####.#.#..##.#.#.####.......#....#.#....####.#...###.#
..#.##...##..##.#.#......###.#...#####.....#...#..####...########.###.#####..##.###...#.#.#..#...###
#.##..#####.#...#..#.#...####.........##..#..#.#.#..##..#.##...###....#.##..#..#.#.#.#.#..#......#.#
.#..##..##.###.##..##...##.#.####..##.###.#..#.###.#####..#..#...##..#.#####........#...###.##.#####
..##..#.###..########.##.#....###.####.#.#..#.#.#...#.#.#..##...##.#..##..##..#.###.##.####...#.....
###.#.###.#.......#.####.###.....#.####.#.#..#...###....#.####........#...##.##.#..#...####.#######.
.##...#...#....##.#.##.###.....#..#..##.#..#..#####..#.##.#####.#....#...#.#.....####.#.###.#.#.###.
######.#.#..#.###.#..#.######.#.#########..##.#.#...##..###.....###...#.###...#.#..###.#.###..####.#
..#.#.##.#.###.#....#.#.####.#..#.##.##.#..###...###...##.#.#.##.##.#.###.#.#...#.#.#..#.##.#####...
###.#...#.#..##...#.....##.#..##.#.###.#..#.##...#......###..##.###.....##.##....#.##.#..#####.#...#
#..#..########...#.#####.###.#...#####....##.#...##...#.#.######.##....###.#.######..#..##.##.#.#.##
..#.#.#....#.#.#.#.#.#..##..#....#...####.##..###.#...#.#.####.##.#....###.#...###.###..#.##.....#.#
#####.####..#.#....#.#......##....##..#######....###.#.#.#.#.#.##.#..##.#..####.###.#...#.###..#.###
#.###..#...###..#...##.#####.###...#.#.#....#######.##.##.###..##..#....##...#.##.#.#...#####.#.#...
.##..##..##..###..#.#..#..#.#.#.#.#..##..###..####.#..###.#.#....########..###.#.#.##.########..##..
.....##..#..####.#.#..#...#..#..#..#...#.#.#####.....#..#.###...######..###...#...#.##.##..##.##..##
.###..####..###...#.####....##..#...#.#.#.....##.#.######....##..###..###.####.##...#......#..##.#..
#...###..#..#.#.#..#..###.###...#..#........#.#.#.##...#.####..#.#.#...####..#.##.#..#....#...#.#..#
#.######..####.######..##.##.#.####.....##..#.#.###.####..#...#..##..#..##.#####.#.#########...##..#
.#.#...#.#..###....###..#....####.#....##..######.....#.####.###.#...##.#..#..#...#.#.#..#..####..##
##..#.#..##..#####..#.###.....##.#.#...##.##..#.##.#......#.#..###.......#####...########..#...#..#.
#..##.###.##.#..##.#..#...####.#.#...#.##..#.###.#.#..#####.###...#.###.####...##...##.#...###.###.#
.#.#....#.##.##.####.##.#.##..###.###.....#..##.#####.....###............#.#.##.#.#..#.#..##.#......
#..##..##.###.#..#.#.###.#####....#..#.#####.##.#.####.#####.#...#..######...#.###..#......##..#..#.
..##.##.#...#.#..###....#.#...#.#.#####..###.###.#..#####.....##..#..#.#.#.#.###.##..##..####.#....#
##...#..##.#.##..###.#..#..##.##...##....#..##..##.#####.###..#.#.##...##.#####.#.##.##....#......#.
#.#..#.#.####......#.##....##.#....###...##.#####....###.#.##.######..###...#..###..####...#####.###
.##.##...###.#.##.##........##..###..#.#####....##.#...#..#####.###.#...##...######.##...###.#..#...
#...#...##.#....#.###.##.##.#####.###..##..#..##.##...##.#.#####...##..##..##........###..#...##.##.
..##..##..##.#..#.#.###..###..##.#.#.#.#.#.......#.##.##.#.##.#####......##....#..#......#.####..##.
.#.#.#....#..#...#..#.##.#.....####.#.###..##.#..#.....###....##.###...##..#.###..###...#.#.#..#...#
..######.##.#####.##.######.##....###....####.....#..##..#.#####.#.#.#.##...###.#####.#......####...
.##..#.#######..#...###..##.#.#.#...#...#####.#.#.##.#.....###..#.##..#.#.#.####.###..#####....###..
..#...##..####....####..#.##...#.....####..#......#.##.###.#....#..#..##.####....###.#..#.###..###..
.##..##..######.##....#.##.#..##.#.#.#...##...#.##.#.##.###..#..###..##.##..#...###..#.#.#..##.###.#
####.#..##.#.###..##.##..#..###..#.#.....#.#.#.##..##..###.#.....#.##.#.#.##.###.###...####.#.##.#.#
.##..#####.###.#...#######.#...#.#.####.####.#..#...#.#..#######..#...##..###.#..#####.##..#.#.##..#
####..####.##....##.#.#.##.#..##...#.##.#.####...#.#####.#.##...#.#.##.##.#..#.###.#.##...###..###.#
.#..##....##..#.##...##..####....###..#....####.#.###...###.#.#..#.#.##.##..###..##.#..###.##.#####.
#.#....######....#....##.#.#.###.#..####...##.###...###..#.###.#..##.##....#...####.#.##....#...#.##
...#..#.###.##.##....####.#.#.######.###....##.######.#..##.#..##...##...###..#######....#.##..#..##
#....#.##.###.##......#....###.##.#..########.#####.##.#######.###.##.###..#.#.#.#...#########..#.##
###.#..#...##.#....##..###.....#.#.#.##..#####.##.###.#.#...#.####.#..####.#....#####..##.#.#.......
##...##...###...#.#.##....##.......#...#........####....#..#.###....#.#.####........##.#...##..#####
.....#...#....#.#####.#..#.#.###.#..###..........#...########.#......#.######..#.#..#.##.#.#..##....
..#.###.#..#.##.##..#.#...####.##.#.##.###...##.#..#..##.#.##...##.....#...##.###......#..#.######..
.##...#..##.##..#.###.#.#..##.#..##..###.##..#.##.....#.#.#######..###.###.##.###..#.#...##..#.#..##
#.#.#.##.##..###.##.#.##.##...#.##.#####.#.#.....###.##..#####.......#.####.#..#.###.###.##.#.#...##
#..#..#.#...#..##..###.##..##.#.###.##...#....#..#...##.#####.##..##.#...###.#..##.###..####.##.##.#